ɑ	AA
æ	AE
ʌ	AH
ɔ	AO
aʊ	AW
aɪ	AY
b	B
tʃ	CH
d	D
ð	DH
ɛ	EH
ɝ	ER
eɪ	EY
f	F
ɡ	G
h	HH
ɪ	IH
i	IY
dʒ	JH
k	K
l	L
m	M
n	N
ŋ	NG
oʊ	OW
ɔɪ	OY
p	P
ɹ	R
s	S
ʃ	SH
t	T
θ	TH
ʊ	UH
u	UW
v	V
w	W
j	Y
z	Z
ʒ	ZH
ŋ	NG
u	UW
