b	b
d	d
ɡ	g
p	p
t	t
k	k
ɾ	dx
ʔ	q
dʒ	jh
tʃ	ch
s	s
ʃ	sh
z	z
ʒ	zh
f	f
θ	th
v	v
ð	dh
m	m
n	n
m̩	em
ŋ	ng
n̩	en
ŋ̍	eng
ɾ̃	nx
l	l
l̩	el
r	r
w	w
j	y
h	hh
ɦ	hv
i	iy
ɪ	ih
ɛ	eh
eɪ	ey
æ	ae
ɑ	aa
aʊ	aw
aɪ	ay
ʌ	ah
ɔ	ao
ɔi	oy
oʊ	ow
ʊ	uh
u	uw
ʉ	ux
ɝ	er
ə	ax
ᵻ	ix
ɚ	axr
ə̥	ax-h
d̚	dcl
b̚	bcl
ɡ̚	gcl
k̚	kcl
p̚	pcl
t̚	tcl

